FFFFFFFFFFFRFFF
FFFFFFFFFFRRRFF
FFFFFFFFFRRRRRF
FFFFFFFFFRRRRFF
FFFFFFFFFRRRFFF
FFFFFFFFFRRFFFF
FFTTTTFFFRFFFFF
FTTTTTTFFRFFTFF
TTTTTTTTTRTTTTT
TTTTTTTTRRTTTTT
TTVVVTTTTRRVTTT
VVVVVVVVVRVVVVV
VVDDVVVVRRVVVDD
VDDDDVDDDRVVVDD
DDDDDDDDDRRDDDD